Alistar=suporte=Quem vai parar o corno agora?=4
Anivia=suporte=Frio=4
Ashe=suporte=Flecha de cristal=4
Bardo=suporte=Ult mais troll do game=4
Braum=suporte=Fissura glacial=4
Fiddlesticks=suporte=Surpresaaa=4
Heimerdinger=suporte=Minhas maquinas evoluidas=4
Ivern=suporte=Margaridaa=4
Janna=suporte=Cura com vento??=4
Karma=suporte=Mesma coisa das habilidades=4
Kayle=suporte=Furia imortal=4
Leona=suporte=Sol que estuna=4
Lulu=suporte=Engrandecer=4
Lux=suporte=AAAAAA piu=4
Morgana=suporte=7s de stun=4
Nami=suporte=Olha onda, olha onda=4
Neeko=suporte=Tomou bolinha de neve e ainda leva para cima do time=4
Orianna=suporte=Nao tira o olho da minha bola em=4
Pyke=suporte=X no seu coraçao=4
Rakan=suporte=Olha meu charma=4
Renata Glasc=suporte=Se batam ai otários=4
Senna=suporte=Escudo, dano, escudo=4
Seraphine=suporte=AAAAAAAAAAAAAAAAAAAAAAAAAAAAAAA=4
Sona=suporte=..................=4
Soraka=suporte=Cura celestial=4
Syndra=suporte=Bola=4
Tahm Kench=suporte=TE COMI=4
Taliyah=suporte=Surfe nas preda=4
Taric=suporte=Imotallll, cabo=4
Thresh=suporte=Caixa da morte=4
Yuumi=suporte=Gata fedorenta=4
Zilean=suporte=Revive ai=4
Zoe=suporte=Pula pula=4
Zyra=suporte=Planta=4